UFRJ	NÃO
PUCRS	NÃO
UCLA	NÃO
PUCMG	NÃO
UFRGS	NÃO
UFMG	NÃO
PUCPR	NÃO
PUCRIO	NÃO
FATERJ	NÃO
FACESTA	NÃO
CEUB	NÃO
FAZAG	NÃO
AVANTIS	(28) SIM
FASAR	NÃO
PUCGO	NÃO
MIT	NÃO
FAEX	NÃO
FLF	(29) SIM
ENSITEC	(13) SIM
UNIFRA	NÃO
EMSM	NÃO
UNINCOR	(6) SIM
Laboro	NÃO
FAMETA	NÃO
IFRR	NÃO
FCAT	NÃO
FAT	NÃO
UFPE	NÃO
SENAC	NÃO
FARESI	NÃO
SENAI	NÃO
FAJANSSEN	NÃO
UFERSA	NÃO
FSA	NÃO
OXFORD	NÃO
FAMA	(5) SIM
USP	NÃO
FMO	NÃO
UFMA	NÃO
FASPI	NÃO
